............C.........C.........C.........C.........C.........
............C.........C.........C.........C.........C.........
............C.........C.........C.........C.........C.........
............C.........C.........C.........C.........C.........
............C.........C.........C.........C.........C.........
............C.........C.........C.........C.........C.........
............C.........C.........C.........C.........C.........
............C.........C.........C.........C.........C.........
..........L.C.L.L.L.L.C.L.L5L.L.C.L.L.L.L.C.L.L.L5L.C.L.......
.........IIIIIIIIIIIIIIIIIIIIIIIIIIIIIIIIIIIIIIIIIIIIIII......
..............................................................
..BBBB........BBBB............BBB..........BB6.........BB6....
..tttt...K.....ttt............ttt..........ttt.........ttt....
.S......KKK.............................7..................X..
gggggggggggggggggggggggggggggggggggggggggggggggggggggggggggggg
